111111111113111111111111111111111111111111111111111111111111
400000100010100000010010000000000000000000000000000000000001
1111000000000000p0010010101111011111111010010100000000000001
300000100010100000010010101000010000001010010111111111111101
111111100010111111010011101000011101111010010000000000000001
100000000010000000000000000000000000001110111111111111111011
111110111111111111111111011111111111111000000001000000000001
100010100000000101100000000000010000001000002001111110111111
101010100000000000100100000000010000000000000000000000000001
101010101111111101110100010100000000001000002001011101111111
101110101010000001010100111111101111111000000001010100000001
100000000011111101010100100010000001001110111111110100000001
111111110110000100010100100000000000001000000000000111110111
100000100000000000000000100010000001001010101111100100000001
11110000001111101111111011111011111111111010000000000e000001
100000100010000000000000100000000000000000100000100100000001
111111144411111111111111111111111111111111111111111111111511